CObject:
1 150 150 50 50 2 1
1 0 150 50 50 2 1
1 50 200 50 50 2 1
1 0 200 50 50 2 1
1 100 150 50 50 2 1
1 250 150 50 50 2 1
1 50 150 50 50 2 1
1 500 150 50 50 2 1
1 300 150 50 50 2 1
1 350 150 50 50 2 1
1 200 150 50 50 2 1
1 400 150 50 50 2 1
1 450 150 50 50 2 1
1 600 150 50 50 2 1
1 650 150 50 50 2 1
1 700 150 50 50 2 1
1 550 150 50 50 2 1
1 800 150 50 50 2 1
1 850 150 50 50 2 1
1 750 150 50 50 2 1
1 900 150 50 50 2 1
1 950 150 50 50 2 1
1 1050 150 50 50 2 1
1 1000 150 50 50 2 1
1 1100 150 50 50 2 1
1 1200 150 50 50 2 1
1 1300 150 50 50 2 1
1 1350 150 50 50 2 1
1 1250 150 50 50 2 1
1 1150 150 50 50 2 1
1 1450 150 50 50 2 1
1 1550 150 50 50 2 1
1 1600 150 50 50 2 1
1 1500 150 50 50 2 1
1 1400 150 50 50 2 1
1 1750 150 50 50 2 1
1 1850 150 50 50 2 1
1 1800 150 50 50 2 1
1 1700 150 50 50 2 1
1 1650 150 50 50 2 1
1 1900 150 50 50 2 1
1 1850 200 50 50 2 1
1 1800 200 50 50 2 1
1 1700 200 50 50 2 1
1 1750 200 50 50 2 1
1 1650 200 50 50 2 1
1 1500 200 50 50 2 1
1 1400 200 50 50 2 1
1 1300 200 50 50 2 1
1 1150 200 50 50 2 1
1 1000 200 50 50 2 1
1 900 200 50 50 2 1
1 750 200 50 50 2 1
1 700 200 50 50 2 1
1 550 200 50 50 2 1
1 450 200 50 50 2 1
1 350 200 50 50 2 1
1 250 200 50 50 2 1
1 150 200 50 50 2 1
1 100 200 50 50 2 1
1 200 200 50 50 2 1
1 100 250 50 50 2 1
1 150 250 50 50 2 1
1 50 300 50 50 2 1
1 0 300 50 50 2 1
1 850 200 50 50 2 1
1 800 200 50 50 2 1
1 650 200 50 50 2 1
1 1450 300 50 50 2 1
1 1450 200 50 50 2 1
1 1450 250 50 50 2 1
5 100 50 50 50 2 1
5 450 50 50 50 2 1
5 850 50 50 50 2 1
5 1300 50 50 50 2 1
5 1700 50 50 50 2 1
2 450 400 50 50 2 1
2 500 350 50 50 2 1
2 550 350 50 50 2 1
2 600 350 50 50 2 1
2 650 350 50 50 2 1
2 700 400 50 50 2 1
2 100 700 50 50 2 1
2 150 650 50 50 2 1
2 200 650 50 50 2 1
2 250 650 50 50 2 1
2 300 700 50 50 2 1
2 700 750 50 50 2 1
2 800 700 50 50 2 1
2 850 700 50 50 2 1
2 750 700 50 50 2 1
2 900 700 50 50 2 1
2 950 750 50 50 2 1
2 1350 500 50 50 2 1
2 1400 450 50 50 2 1
2 1450 450 50 50 2 1
2 1500 450 50 50 2 1
2 1550 450 50 50 2 1
2 1600 500 50 50 2 1
4 1900 250 50 50 2 1
4 1900 300 50 50 2 1
4 1900 350 50 50 2 1
4 1900 400 50 50 2 1
4 1900 450 50 50 2 1
4 1900 500 50 50 2 1
4 1900 550 50 50 2 1
4 1900 600 50 50 2 1
4 1900 650 50 50 2 1
4 1900 700 50 50 2 1
4 1900 750 50 50 2 1
4 1900 800 50 50 2 1
4 1900 850 50 50 2 1
4 1900 900 50 50 2 1
4 1900 950 50 50 2 1
4 1850 950 50 50 2 1
4 1850 900 50 50 2 1
4 1850 850 50 50 2 1
4 1850 800 50 50 2 1
4 1850 750 50 50 2 1
4 1850 700 50 50 2 1
4 1850 650 50 50 2 1
4 1850 600 50 50 2 1
4 1850 550 50 50 2 1
4 1850 450 50 50 2 1
4 1850 400 50 50 2 1
4 1850 350 50 50 2 1
4 1850 300 50 50 2 1
4 1850 250 50 50 2 1
4 1850 500 50 50 2 1
4 1900 200 50 50 2 1
15 0 1000 50 50 2 2
15 0 1050 50 50 2 1
15 50 1000 50 50 2 1
15 50 1050 50 50 2 1
15 100 1000 50 50 2 1
15 100 1050 50 50 2 2
15 150 1000 50 50 2 2
15 150 1050 50 50 2 2
15 200 1000 50 50 2 1
15 200 1050 50 50 2 1
15 250 1000 50 50 2 1
15 250 1050 50 50 2 2
15 300 1050 50 50 2 1
15 300 1000 50 50 2 1
15 350 1050 50 50 2 1
15 350 1000 50 50 2 1
15 400 1000 50 50 2 2
15 400 1050 50 50 2 1
15 450 1000 50 50 2 1
15 450 1050 50 50 2 2
15 500 1000 50 50 2 1
15 500 1050 50 50 2 1
15 550 1000 50 50 2 2
15 550 1050 50 50 2 1
15 600 950 50 50 2 1
15 600 1050 50 50 2 2
15 600 1000 50 50 2 1
15 650 1000 50 50 2 1
15 650 1050 50 50 2 2
15 700 1000 50 50 2 1
15 700 1050 50 50 2 2
15 750 1000 50 50 2 1
15 750 1050 50 50 2 1
15 800 1000 50 50 2 1
15 800 1050 50 50 2 2
15 850 1000 50 50 2 1
15 850 1050 50 50 2 1
15 900 1000 50 50 2 1
15 900 1050 50 50 2 1
15 950 1000 50 50 2 1
15 950 1050 50 50 2 1
15 1000 1000 50 50 2 1
15 1000 1050 50 50 2 2
15 1050 1000 50 50 2 1
15 1050 1050 50 50 2 1
15 1100 1000 50 50 2 1
15 1100 1050 50 50 2 1
15 1150 1000 50 50 2 2
15 1150 1050 50 50 2 1
15 1200 1000 50 50 2 1
15 1200 1050 50 50 2 2
15 1250 1050 50 50 2 2
15 1250 1000 50 50 2 2
15 1300 1000 50 50 2 1
15 1300 1050 50 50 2 1
15 1350 1050 50 50 2 2
15 1350 1000 50 50 2 2
15 1450 1000 50 50 2 1
15 1400 1050 50 50 2 1
15 1400 1000 50 50 2 1
15 1450 1050 50 50 2 1
15 1500 1000 50 50 2 1
15 1500 1050 50 50 2 2
15 1550 1050 50 50 2 1
15 1550 1000 50 50 2 2
15 1600 1050 50 50 2 1
15 1600 1000 50 50 2 1
15 1650 1000 50 50 2 2
15 1650 1050 50 50 2 1
15 1700 1050 50 50 2 1
15 1700 1000 50 50 2 1
15 1750 1000 50 50 2 2
15 1750 1050 50 50 2 1
15 1800 1000 50 50 2 1
15 1800 1050 50 50 2 2
15 1850 1050 50 50 2 1
15 1850 1000 50 50 2 2
15 1900 1000 50 50 2 1
15 1900 1050 50 50 2 2
15 100 950 50 50 2 1
15 300 950 50 50 2 1
15 350 950 50 50 2 1
15 750 950 50 50 2 1
15 900 950 50 50 2 1
15 1050 950 50 50 2 1
15 1150 950 50 50 2 1
15 1350 950 50 50 2 1
15 1450 950 50 50 2 1
15 1650 950 50 50 2 1
15 1750 950 50 50 2 1
15 1800 950 50 50 2 1
14 350 850 50 50 2 1
14 550 800 50 50 2 1
14 650 850 50 50 2 1
14 1400 850 50 50 2 1
14 1500 750 50 50 2 1
14 1550 700 50 50 2 1
14 1550 650 50 50 2 1
14 1700 850 50 50 2 1
14 1300 450 50 50 2 1
14 1350 450 50 50 2 1
14 1300 500 50 50 2 1
14 1300 550 50 50 2 1
14 1350 550 50 50 2 1
14 1400 550 50 50 2 1
14 1450 500 50 50 2 1
14 1450 550 50 50 2 1
14 1400 500 50 50 2 1
14 1500 500 50 50 2 1
14 1500 550 50 50 2 1
14 1550 500 50 50 2 1
14 1550 550 50 50 2 1
14 1600 550 50 50 2 1
14 1650 550 50 50 2 1
14 1650 500 50 50 2 1
14 1650 450 50 50 2 1
14 1550 400 50 50 2 1
14 1450 400 50 50 2 1
14 1400 400 50 50 2 1
14 1500 400 50 50 2 1
14 1600 450 50 50 2 1
14 500 400 50 50 2 1
14 550 400 50 50 2 1
14 600 400 50 50 2 1
14 650 400 50 50 2 1
14 650 450 50 50 2 1
14 700 450 50 50 2 1
14 600 450 50 50 2 1
14 550 450 50 50 2 1
14 450 450 50 50 2 1
14 400 450 50 50 2 1
14 400 400 50 50 2 1
14 450 350 50 50 2 1
14 500 450 50 50 2 1
14 500 300 50 50 2 1
14 600 300 50 50 2 1
14 650 300 50 50 2 1
14 550 300 50 50 2 1
14 700 350 50 50 2 1
14 750 400 50 50 2 1
14 150 600 50 50 2 1
14 250 600 50 50 2 1
14 200 600 50 50 2 1
14 100 650 50 50 2 1
14 50 700 50 50 2 1
14 50 750 50 50 2 1
14 100 750 50 50 2 1
14 150 750 50 50 2 1
14 150 700 50 50 2 1
14 200 700 50 50 2 1
14 200 750 50 50 2 1
14 250 700 50 50 2 1
14 250 750 50 50 2 1
14 350 700 50 50 2 1
14 300 650 50 50 2 1
14 300 750 50 50 2 1
14 700 700 50 50 2 1
14 650 800 50 50 2 1
14 700 800 50 50 2 1
14 750 800 50 50 2 1
14 750 750 50 50 2 1
14 850 750 50 50 2 1
14 900 750 50 50 2 1
14 800 750 50 50 2 1
14 750 650 50 50 2 1
14 800 650 50 50 2 1
14 850 650 50 50 2 1
14 900 650 50 50 2 1
14 950 700 50 50 2 1
14 1000 700 50 50 2 1
14 1000 750 50 50 2 1
14 950 800 50 50 2 1
14 650 750 50 50 2 1
14 1000 800 50 50 2 1
14 900 800 50 50 2 1
6 150 700 50 50 2 1
6 500 400 50 50 2 1
7 900 750 50 50 2 1
7 1500 500 50 50 2 1
15 50 50 50 50 2 1
15 50 100 50 50 2 1
15 100 100 50 50 2 1
15 150 100 50 50 2 1
15 150 50 50 50 2 1
15 150 0 50 50 2 1
15 100 0 50 50 2 1
15 50 0 50 50 2 1
15 0 50 50 50 2 1
15 350 50 50 50 2 1
15 450 100 50 50 2 1
15 400 50 50 50 2 1
15 400 100 50 50 2 1
15 500 50 50 50 2 1
15 500 0 50 50 2 1
15 450 0 50 50 2 1
15 750 50 50 50 2 1
15 800 100 50 50 2 1
15 800 50 50 50 2 1
15 850 100 50 50 2 1
15 900 50 50 50 2 1
15 950 100 50 50 2 1
15 900 100 50 50 2 1
15 900 0 50 50 2 1
15 850 0 50 50 2 1
15 1250 50 50 50 2 1
15 1200 50 50 50 2 1
15 1300 100 50 50 2 1
15 1250 100 50 50 2 1
15 1350 100 50 50 2 1
15 1350 50 50 50 2 1
15 1350 0 50 50 2 1
15 1300 0 50 50 2 1
15 1600 50 50 50 2 1
15 1650 100 50 50 2 1
15 1650 50 50 50 2 1
15 1700 100 50 50 2 1
15 1750 100 50 50 2 1
15 1750 50 50 50 2 1
15 1750 0 50 50 2 1
15 1700 0 50 50 2 1
CPlayer:
100 900 0 1 1 1 1
CEnemy:
200 300 100 100 0 5 10 1
1000 350 100 100 0 5 10 1
50 500 100 100 0 5 10 1
1550 350 100 100 0 5 10 1
