CObject:
CEnemy:
100 950 50 50 0 5 10 4
350 850 50 50 0 5 10 4
800 900 50 50 0 5 10 4
1150 850 50 50 0 5 10 4
1650 900 50 50 0 5 10 4
50 850 50 50 0 5 10 4
150 800 50 50 0 5 10 4
100 50 50 50 0 5 10 4
1650 50 50 50 0 5 10 4
50 650 50 50 0 5 10 4
0 750 50 50 0 5 10 4
50 750 50 50 0 5 10 4
0 850 50 50 0 5 10 4
0 800 50 50 0 5 10 4
50 800 50 50 0 5 10 4
0 900 50 50 0 5 10 4
