CObject:
16 100 650 50 50 2 1
16 100 700 50 50 2 1
16 100 750 50 50 2 1
16 100 800 50 50 2 1
16 100 850 50 50 2 1
16 150 850 50 50 2 1
16 200 850 50 50 2 1
16 250 850 50 50 2 1
16 300 850 50 50 2 1
16 300 800 50 50 2 1
16 300 750 50 50 2 1
16 300 700 50 50 2 1
16 300 650 50 50 2 1
16 250 650 50 50 2 1
16 200 650 50 50 2 1
16 150 650 50 50 2 1
16 650 700 50 50 2 1
16 650 750 50 50 2 1
16 650 800 50 50 2 1
16 1200 50 50 50 2 1
16 750 800 50 50 2 1
16 750 750 50 50 2 1
16 750 700 50 50 2 1
16 700 700 50 50 2 1
16 700 800 50 50 2 1
16 1250 50 50 50 2 1
16 1300 50 50 50 2 1
16 1350 50 50 50 2 1
16 1350 100 50 50 2 1
16 1350 150 50 50 2 1
16 1350 200 50 50 2 1
16 1300 200 50 50 2 1
16 1250 200 50 50 2 1
16 1200 200 50 50 2 1
16 1200 100 50 50 2 1
16 1200 150 50 50 2 1
2 150 700 50 50 2 1
2 150 750 50 50 2 1
2 150 800 50 50 2 1
2 200 700 50 50 2 1
2 200 750 50 50 2 1
2 200 800 50 50 2 1
2 250 700 50 50 2 1
2 250 750 50 50 2 1
2 250 800 50 50 2 1
2 700 750 50 50 2 1
2 1250 100 100 100 2 1
2 150 150 50 50 2 1
2 150 200 50 50 2 1
2 200 150 50 50 2 1
2 200 200 50 50 2 1
16 100 250 50 50 2 1
16 150 250 50 50 2 1
16 200 250 50 50 2 1
16 250 250 50 50 2 1
16 250 200 50 50 2 1
16 250 150 50 50 2 1
16 250 100 50 50 2 1
16 200 100 50 50 2 1
16 150 100 50 50 2 1
16 100 100 50 50 2 1
16 100 150 50 50 2 1
16 100 200 50 50 2 1
CEnemy:
375 726 100 100 0 5 10 1
1600 450 50 50 0 5 10 1
1600 250 50 50 0 5 10 1
1550 200 50 50 0 5 10 1
1550 300 50 50 0 5 10 1
1500 500 50 50 0 5 10 1
1550 650 50 50 0 5 10 1
1550 50 50 50 0 5 10 1
1500 100 50 50 0 5 10 1
1500 700 50 50 0 5 10 1
1450 750 50 50 0 5 10 1
