CObject:
2 0 0 50 50 2 1
2 50 0 50 50 2 1
2 150 0 50 50 2 1
2 200 0 50 50 2 1
2 100 0 50 50 2 1
2 300 0 50 50 2 1
2 350 0 50 50 2 1
2 250 0 50 50 2 1
2 400 0 50 50 2 1
2 450 0 50 50 2 1
2 550 0 50 50 2 1
2 600 0 50 50 2 1
2 700 0 50 50 2 1
2 800 0 50 50 2 1
2 650 0 50 50 2 1
2 750 0 50 50 2 1
2 500 0 50 50 2 1
2 850 0 50 50 2 1
2 900 0 50 50 2 1
2 950 0 50 50 2 1
2 1000 0 50 50 2 1
2 1050 0 50 50 2 1
2 1100 0 50 50 2 1
2 1150 0 50 50 2 1
2 1200 0 50 50 2 1
2 1300 0 50 50 2 1
2 1350 0 50 50 2 1
2 1250 0 50 50 2 1
2 1500 0 50 50 2 1
2 1550 0 50 50 2 1
2 1450 0 50 50 2 1
2 1400 0 50 50 2 1
2 1600 0 50 50 2 1
2 1650 0 50 50 2 1
2 1650 50 50 50 2 1
2 1650 100 50 50 2 1
2 1650 150 50 50 2 1
2 1650 200 50 50 2 1
2 1650 250 50 50 2 1
2 1650 300 50 50 2 1
2 1650 350 50 50 2 1
2 1650 400 50 50 2 1
2 1650 450 50 50 2 1
2 1650 500 50 50 2 1
2 1650 550 50 50 2 1
2 1650 600 50 50 2 1
2 1650 650 50 50 2 1
2 1650 700 50 50 2 1
2 1650 750 50 50 2 1
2 1650 800 50 50 2 1
2 1650 850 50 50 2 1
2 1650 900 50 50 2 1
2 1650 950 50 50 2 1
2 1600 950 50 50 2 1
2 1600 900 50 50 2 1
2 1550 950 50 50 2 1
2 1550 900 50 50 2 1
2 1450 950 50 50 2 1
2 1550 850 50 50 2 1
2 1500 950 50 50 2 1
2 1500 900 50 50 2 1
2 1600 850 50 50 2 1
2 1700 50 50 50 2 1
2 1750 100 50 50 2 1
2 1700 400 50 50 2 1
2 1750 450 50 50 2 1
2 1700 650 50 50 2 1
2 1750 800 50 50 2 1
2 1700 850 50 50 2 1
2 1700 950 50 50 2 1
2 1700 1000 50 50 2 1
2 1750 1000 50 50 2 1
2 1650 1050 50 50 2 1
2 1650 1000 50 50 2 1
2 1600 1000 50 50 2 1
2 1600 1050 50 50 2 1
2 1550 1050 50 50 2 1
2 1550 1000 50 50 2 1
2 1500 1000 50 50 2 1
2 1500 1050 50 50 2 1
2 1450 1000 50 50 2 1
2 1450 1050 50 50 2 1
2 1400 1000 50 50 2 1
2 1400 1050 50 50 2 1
2 1350 1050 50 50 2 1
2 1350 950 50 50 2 1
2 1350 1000 50 50 2 1
2 1300 1000 50 50 2 1
2 1300 1050 50 50 2 1
2 1250 1050 50 50 2 1
15 1700 1050 50 50 2 1
15 1750 1050 50 50 2 1
15 1800 1050 50 50 2 1
15 1850 1050 50 50 2 1
15 1900 1000 50 50 2 1
15 1850 950 50 50 2 1
15 1800 1000 50 50 2 1
15 1900 1050 50 50 2 1
15 1850 1000 50 50 2 1
15 1900 950 50 50 2 1
15 1600 800 50 50 2 1
15 1550 750 50 50 2 1
2 1600 800 50 50 2 1
2 1550 750 50 50 2 1
2 1400 750 50 50 2 1
2 1250 800 50 50 2 1
2 1300 850 50 50 2 1
2 1450 850 50 50 2 1
2 1400 850 50 50 2 1
15 1800 950 50 50 2 1
15 1750 950 50 50 2 1
15 1750 900 50 50 2 1
15 1700 900 50 50 2 1
15 1750 850 50 50 2 1
15 1700 750 50 50 2 1
15 1700 800 50 50 2 1
15 1750 700 50 50 2 1
14 1750 750 50 50 2 1
15 1750 600 50 50 2 1
14 1800 700 50 50 2 1
15 1700 600 50 50 2 1
15 1700 550 50 50 2 1
15 1700 700 50 50 2 1
15 1700 500 50 50 2 1
15 1700 450 50 50 2 1
14 1750 650 50 50 2 1
15 1750 400 50 50 2 1
14 1850 750 50 50 2 1
14 1850 600 50 50 2 1
14 1750 550 50 50 2 1
14 1750 500 50 50 2 1
14 1850 500 50 50 2 1
14 1800 400 50 50 2 1
15 1750 150 50 50 2 1
14 1800 350 50 50 2 1
15 1700 100 50 50 2 1
14 1700 350 50 50 2 1
15 1800 0 50 50 2 1
15 1750 0 50 50 2 1
14 1750 300 50 50 2 1
14 1800 300 50 50 2 1
15 1800 750 50 50 2 1
15 1800 600 50 50 2 1
14 1750 250 50 50 2 1
15 1850 800 50 50 2 1
14 1750 200 50 50 2 1
1 1700 300 50 50 2 1
1 1700 250 50 50 2 1
1 1700 200 50 50 2 1
1 1800 200 50 50 2 1
1 1800 250 50 50 2 1
1 1850 250 50 50 2 1
1 1750 350 50 50 2 1
14 1700 150 50 50 2 1
1 1850 350 50 50 2 1
1 1900 350 50 50 2 1
1 1850 300 50 50 2 1
1 1850 450 50 50 2 1
1 1850 400 50 50 2 1
1 1800 450 50 50 2 1
1 1800 500 50 50 2 1
14 1800 150 50 50 2 1
1 1800 550 50 50 2 1
1 1850 550 50 50 2 1
1 1850 650 50 50 2 1
1 1800 650 50 50 2 1
1 1800 850 50 50 2 1
1 1850 700 50 50 2 1
1 1900 250 50 50 2 1
1 1900 100 50 50 2 1
1 1800 50 50 50 2 1
1 1750 0 50 50 2 1
1 1700 0 50 50 2 1
1 1850 200 50 50 2 1
1 1700 550 50 50 2 1
14 1850 150 50 50 2 1
14 1800 100 50 50 2 1
14 1750 50 50 50 2 1
14 1850 0 50 50 2 1
2 150 350 50 50 2 1
2 200 350 50 50 2 1
2 250 350 50 50 2 1
2 250 400 50 50 2 1
2 200 400 50 50 2 1
2 150 400 50 50 2 1
2 150 450 50 50 2 1
2 200 450 50 50 2 1
2 250 450 50 50 2 1
2 650 450 50 50 2 1
2 650 550 50 50 2 1
2 700 450 50 50 2 1
2 700 500 50 50 2 1
2 750 450 50 50 2 1
2 700 550 50 50 2 1
2 750 550 50 50 2 1
2 1250 350 200 200 2 1
1 100 300 50 50 2 1
1 100 350 50 50 2 1
1 100 400 50 50 2 1
1 100 450 50 50 2 1
1 100 500 50 50 2 1
1 200 500 50 50 2 1
1 250 500 50 50 2 1
1 300 500 50 50 2 1
1 150 500 50 50 2 1
1 300 450 50 50 2 1
1 300 400 50 50 2 1
1 300 350 50 50 2 1
1 300 300 50 50 2 1
1 250 300 50 50 2 1
1 200 300 50 50 2 1
1 150 300 50 50 2 1
1 600 500 50 50 2 1
1 650 500 50 50 2 1
1 600 550 50 50 2 1
1 600 600 50 50 2 1
1 650 600 50 50 2 1
1 700 600 50 50 2 1
1 750 600 50 50 2 1
1 800 600 50 50 2 1
1 800 550 50 50 2 1
1 800 500 50 50 2 1
1 750 500 50 50 2 1
1 800 450 50 50 2 1
1 800 400 50 50 2 1
1 750 400 50 50 2 1
1 700 400 50 50 2 1
1 650 400 50 50 2 1
1 600 400 50 50 2 1
1 600 450 50 50 2 1
1 600 350 50 50 2 1
1 700 350 50 50 2 1
1 500 550 50 50 2 1
1 700 700 50 50 2 1
1 900 500 50 50 2 1
1 150 200 50 50 2 1
1 50 450 50 50 2 1
1 50 350 50 50 2 1
1 200 550 50 50 2 1
1 350 400 50 50 2 1
1 350 300 50 50 2 1
1 200 250 50 50 2 1
1 1200 350 50 50 2 1
1 1200 400 50 50 2 1
1 1200 450 50 50 2 1
1 1200 500 50 50 2 1
1 1200 550 50 50 2 1
1 1200 600 50 50 2 1
1 1300 550 50 50 2 1
1 1350 550 50 50 2 1
1 1250 550 50 50 2 1
1 1400 550 50 50 2 1
1 1450 550 50 50 2 1
1 1450 500 50 50 2 1
1 1450 450 50 50 2 1
1 1450 400 50 50 2 1
1 1450 350 50 50 2 1
1 1450 300 50 50 2 1
1 1450 250 50 50 2 1
1 1350 300 50 50 2 1
1 1250 300 50 50 2 1
1 1200 300 50 50 2 1
1 1150 300 50 50 2 1
1 1400 300 50 50 2 1
1 1300 300 50 50 2 1
1 1500 550 50 50 2 1
5 150 100 50 50 2 1
5 1350 100 50 50 2 1
8 450 100 50 50 2 1
8 1150 100 50 50 2 1
8 800 100 50 50 2 1
14 100 600 50 50 2 1
14 400 450 50 50 2 1
14 400 300 50 50 2 1
14 350 200 50 50 2 1
14 50 300 50 50 2 1
14 750 650 50 50 2 1
14 550 500 50 50 2 1
14 800 350 50 50 2 1
14 1100 400 50 50 2 1
14 1300 200 50 50 2 1
14 1350 600 50 50 2 1
14 1550 400 50 50 2 1
14 1150 500 50 50 2 1
14 1500 450 50 50 2 1
14 1400 900 50 50 2 1
14 1400 950 50 50 2 1
14 1450 900 50 50 2 1
14 1350 900 50 50 2 1
14 1300 950 50 50 2 1
14 1550 800 50 50 2 1
14 1500 850 50 50 2 1
6 150 800 50 50 2 1
6 600 650 50 50 2 1
12 1250 600 50 50 2 1
7 50 400 50 50 2 1
7 750 350 50 50 2 1
7 1500 500 50 50 2 1
7 500 900 50 50 2 1
CEnemy:
671 221 100 100 20 5 15 5
250 150 60 60 0 5 10 2
800 200 60 60 0 5 10 2
1500 150 60 60 0 5 10 2
550 200 60 60 0 5 10 2
