CObject:
8 350 800 50 50 2 3
8 600 800 50 50 2 3
8 850 800 50 50 2 3
8 1100 800 50 50 2 3
8 350 150 50 50 2 3
8 600 150 50 50 2 3
8 850 150 50 50 2 3
8 1100 150 50 50 2 3
CEnemy:
0 350 50 50 0 5 10 0
50 450 50 50 0 5 10 0
50 500 50 50 0 5 10 0
200 400 50 50 0 5 10 0
50 400 50 50 0 5 10 0
150 500 50 50 0 5 10 0
200 500 50 50 0 5 10 0
200 450 50 50 0 5 10 0
450 450 50 50 0 5 10 0
350 250 50 50 0 5 10 0
550 200 50 50 0 5 10 0
500 850 50 50 0 5 10 0
750 750 50 50 0 5 10 0
550 700 50 50 0 5 10 0
450 750 50 50 0 5 10 0
500 750 50 50 0 5 10 0
650 750 50 50 0 5 10 0
800 750 50 50 0 5 10 0
1000 750 50 50 0 5 10 0
950 750 50 50 0 5 10 0
800 800 50 50 0 5 10 0
600 800 50 50 0 5 10 0
400 700 50 50 0 5 10 0
1100 700 50 50 0 5 10 0
1050 800 50 50 0 5 10 0
900 850 50 50 0 5 10 0
