CObject:
2 100 150 50 50 2 1
2 500 150 50 50 2 1
2 550 150 50 50 2 1
2 600 200 50 50 2 1
2 200 150 50 50 2 1
2 250 150 50 50 2 1
2 350 150 50 50 2 1
2 400 150 50 50 2 1
2 300 150 50 50 2 1
2 450 150 50 50 2 1
2 600 250 50 50 2 1
2 600 300 50 50 2 1
2 850 200 50 50 2 1
2 850 250 50 50 2 1
2 850 300 50 50 2 1
2 900 150 50 50 2 1
2 950 150 50 50 2 1
2 850 150 50 50 2 1
2 600 150 50 50 2 1
2 1000 150 50 50 2 1
2 1050 150 50 50 2 1
2 1100 150 50 50 2 1
2 1150 150 50 50 2 1
2 1200 150 50 50 2 1
2 1250 150 50 50 2 1
2 1300 150 50 50 2 1
2 1350 150 50 50 2 1
2 1400 150 50 50 2 1
2 1450 150 50 50 2 1
1 550 200 50 50 2 1
1 550 250 50 50 2 1
1 550 300 50 50 2 1
1 550 350 50 50 2 1
1 600 350 50 50 2 1
1 500 250 50 50 2 1
1 700 350 50 50 2 1
1 700 250 50 50 2 1
1 700 200 50 50 2 1
1 700 300 50 50 2 1
1 750 250 50 50 2 1
1 650 250 50 50 2 1
1 650 300 50 50 2 1
1 650 350 50 50 2 1
1 750 300 50 50 2 1
1 850 350 50 50 2 1
1 800 300 50 50 2 1
1 750 200 50 50 2 1
1 800 200 50 50 2 1
1 650 200 50 50 2 1
1 800 250 50 50 2 1
1 400 200 50 50 2 1
1 450 200 50 50 2 1
1 450 250 50 50 2 1
1 500 350 50 50 2 1
1 700 400 50 50 2 1
1 800 400 50 50 2 1
1 750 350 50 50 2 1
1 600 450 50 50 2 1
1 650 400 50 50 2 1
1 350 300 50 50 2 1
1 350 250 50 50 2 1
1 250 200 50 50 2 1
1 150 200 50 50 2 1
1 50 200 50 50 2 1
1 0 150 50 50 2 1
1 50 100 50 50 2 1
1 50 150 50 50 2 1
1 0 100 50 50 2 1
1 100 100 50 50 2 1
1 150 150 50 50 2 1
1 100 250 50 50 2 1
1 0 200 50 50 2 1
1 200 300 50 50 2 1
1 350 200 50 50 2 1
1 500 200 50 50 2 1
1 300 200 50 50 2 1
1 200 200 50 50 2 1
1 100 200 50 50 2 1
1 0 250 50 50 2 1
1 50 250 50 50 2 1
1 150 250 50 50 2 1
1 100 300 50 50 2 1
1 0 300 50 50 2 1
1 200 250 50 50 2 1
1 250 250 50 50 2 1
1 300 300 50 50 2 1
1 250 300 50 50 2 1
1 300 250 50 50 2 1
1 400 300 50 50 2 1
1 450 300 50 50 2 1
1 400 250 50 50 2 1
1 500 300 50 50 2 1
1 950 200 50 50 2 1
1 900 200 50 50 2 1
1 1000 200 50 50 2 1
1 1050 200 50 50 2 1
1 1100 200 50 50 2 1
1 1150 200 50 50 2 1
1 1200 200 50 50 2 1
1 1250 200 50 50 2 1
1 1300 200 50 50 2 1
1 1400 200 50 50 2 1
1 1450 200 50 50 2 1
1 1350 200 50 50 2 1
1 1400 250 50 50 2 1
1 1450 250 50 50 2 1
1 1300 250 50 50 2 1
1 1150 250 50 50 2 1
1 1000 250 50 50 2 1
1 900 250 50 50 2 1
1 1050 300 50 50 2 1
1 1050 250 50 50 2 1
1 150 300 50 50 2 1
1 50 300 50 50 2 1
1 950 300 50 50 2 1
1 1000 300 50 50 2 1
1 1200 300 50 50 2 1
1 1250 250 50 50 2 1
1 900 400 50 50 2 1
1 450 350 50 50 2 1
1 850 450 50 50 2 1
1 700 450 50 50 2 1
1 800 450 50 50 2 1
1 750 400 50 50 2 1
1 900 450 50 50 2 1
1 850 400 50 50 2 1
1 800 350 50 50 2 1
1 650 450 50 50 2 1
1 750 550 50 50 2 1
1 750 500 50 50 2 1
1 650 500 50 50 2 1
1 550 400 50 50 2 1
1 750 450 50 50 2 1
2 200 500 50 50 2 1
2 200 550 50 50 2 1
2 250 500 50 50 2 1
2 250 550 50 50 2 1
2 400 800 50 50 2 1
2 400 850 50 50 2 1
2 450 800 50 50 2 1
2 450 850 50 50 2 1
2 1150 550 50 50 2 1
2 1150 600 50 50 2 1
2 1200 550 50 50 2 1
2 700 650 100 100 2 1
2 1200 600 50 50 2 1
1 1150 800 100 100 2 1
1 1400 900 50 50 2 1
1 1400 950 50 50 2 1
1 1450 900 50 50 2 1
1 1450 950 50 50 2 1
15 1450 300 50 50 2 1
15 1450 350 50 50 2 1
15 1450 400 50 50 2 1
15 1450 450 50 50 2 1
15 1450 500 50 50 2 1
15 1450 550 50 50 2 1
15 1450 600 50 50 2 1
15 1450 650 50 50 2 1
15 1450 700 50 50 2 1
15 1450 750 50 50 2 1
15 1450 800 50 50 2 1
15 1450 850 50 50 2 1
15 1450 0 50 50 2 1
15 1450 50 50 50 2 1
15 1450 100 50 50 2 1
15 1450 150 50 50 2 1
15 1450 200 50 50 2 1
15 1450 250 50 50 2 1
15 1400 0 50 50 2 1
15 1400 50 50 50 2 1
15 1400 100 50 50 2 1
15 1400 300 50 50 2 1
15 1350 350 50 50 2 1
15 1400 400 50 50 2 1
15 1400 450 50 50 2 1
15 1400 500 50 50 2 1
15 1350 600 50 50 2 1
15 1400 650 50 50 2 1
15 1400 700 50 50 2 1
15 1400 750 50 50 2 1
15 1350 750 50 50 2 1
15 1350 0 50 50 2 1
15 1350 50 50 50 2 1
15 1300 50 50 50 2 1
15 1300 450 50 50 2 1
15 1350 550 50 50 2 1
15 1350 800 50 50 2 1
15 1400 900 50 50 2 1
15 1350 900 50 50 2 1
15 1400 850 50 50 2 1
15 1350 950 50 50 2 1
6 200 100 50 50 2 1
6 400 100 50 50 2 1
6 1000 100 50 50 2 1
6 1250 100 50 50 2 1
7 250 100 50 50 2 1
7 300 100 50 50 2 1
13 1050 100 50 50 2 1
7 1100 100 50 50 2 1
5 250 50 50 50 2 1
5 500 50 50 50 2 1
5 800 50 50 50 2 1
5 1200 50 50 50 2 1
15 0 0 50 50 2 1
15 50 50 50 50 2 1
15 100 0 50 50 2 1
15 150 50 50 50 2 1
15 200 0 50 50 2 1
15 350 0 50 50 2 1
15 350 50 50 50 2 1
15 450 0 50 50 2 1
15 500 100 50 50 2 1
15 550 50 50 50 2 1
15 550 0 50 50 2 1
15 750 100 50 50 2 1
15 750 0 50 50 2 1
15 650 50 50 50 2 1
15 950 50 50 50 2 1
15 900 0 50 50 2 1
15 850 100 50 50 2 1
15 1150 0 50 50 2 1
15 1050 0 50 50 2 1
15 1150 100 50 50 2 1
15 1250 0 50 50 2 1
14 50 350 50 50 2 1
14 100 350 50 50 2 1
14 150 350 50 50 2 1
14 200 350 50 50 2 1
14 250 350 50 50 2 1
14 350 400 50 50 2 1
14 400 450 50 50 2 1
14 450 450 50 50 2 1
14 550 450 50 50 2 1
14 600 400 50 50 2 1
14 500 400 50 50 2 1
14 400 400 50 50 2 1
14 350 350 50 50 2 1
14 300 350 50 50 2 1
14 200 450 50 50 2 1
14 350 450 50 50 2 1
14 450 550 50 50 2 1
14 600 500 50 50 2 1
14 550 500 50 50 2 1
14 650 550 50 50 2 1
14 700 500 50 50 2 1
14 700 600 50 50 2 1
14 650 600 50 50 2 1
14 800 550 50 50 2 1
14 850 500 50 50 2 1
14 950 500 50 50 2 1
14 950 450 50 50 2 1
14 950 350 50 50 2 1
14 900 300 50 50 2 1
14 900 350 50 50 2 1
14 950 250 50 50 2 1
14 1000 400 50 50 2 1
14 1100 300 50 50 2 1
14 1150 300 50 50 2 1
14 1200 250 50 50 2 1
14 1250 350 50 50 2 1
14 1300 300 50 50 2 1
14 850 550 50 50 2 1
14 800 600 50 50 2 1
14 700 550 50 50 2 1
14 350 750 50 50 2 1
14 300 800 50 50 2 1
14 350 850 50 50 2 1
14 450 900 50 50 2 1
14 500 850 50 50 2 1
14 500 750 50 50 2 1
14 450 750 50 50 2 1
14 400 750 50 50 2 1
14 350 800 50 50 2 1
14 350 900 50 50 2 1
14 400 900 50 50 2 1
14 500 800 50 50 2 1
14 500 900 50 50 2 1
14 550 750 50 50 2 1
14 400 700 50 50 2 1
14 150 500 50 50 2 1
14 150 550 50 50 2 1
14 150 600 50 50 2 1
14 250 600 50 50 2 1
14 300 600 50 50 2 1
14 300 550 50 50 2 1
14 300 500 50 50 2 1
14 300 450 50 50 2 1
14 250 450 50 50 2 1
14 100 450 50 50 2 1
14 100 600 50 50 2 1
14 200 600 50 50 2 1
14 200 650 50 50 2 1
14 1150 500 50 50 2 1
14 1200 500 50 50 2 1
14 1250 550 50 50 2 1
14 1250 600 50 50 2 1
14 1250 650 50 50 2 1
14 1150 650 50 50 2 1
14 1100 550 50 50 2 1
14 1050 600 50 50 2 1
14 1100 600 50 50 2 1
14 1200 700 50 50 2 1
14 1100 800 50 50 2 1
14 1100 850 50 50 2 1
14 1050 850 50 50 2 1
14 1150 750 50 50 2 1
14 1200 750 50 50 2 1
14 1250 850 50 50 2 1
14 1250 800 50 50 2 1
14 1200 900 50 50 2 1
14 1100 900 50 50 2 1
14 650 650 50 50 2 1
14 650 700 50 50 2 1
14 700 750 50 50 2 1
14 800 750 50 50 2 1
14 600 700 50 50 2 1
4 300 0 50 50 2 1
4 350 0 50 50 2 1
4 400 0 50 50 2 1
4 450 0 50 50 2 1
4 500 0 50 50 2 1
4 550 0 50 50 2 1
4 600 0 50 50 2 1
4 650 0 50 50 2 1
4 700 0 50 50 2 1
4 750 0 50 50 2 1
4 800 0 50 50 2 1
4 850 0 50 50 2 1
4 900 0 50 50 2 1
4 950 0 50 50 2 1
4 1000 0 50 50 2 1
4 1050 0 50 50 2 1
4 1100 0 50 50 2 1
4 1150 0 50 50 2 1
4 1200 0 50 50 2 1
CEnemy:
1079 375 75 75 10 3 5 3
823 664 60 60 15 4 5 3
