CObject:
6 100 50 50 50 2 1
6 100 200 50 50 2 1
6 100 400 50 50 2 1
6 100 600 50 50 2 1
6 100 800 50 50 2 1
6 100 900 50 50 2 1
5 1050 100 50 50 2 1
5 1050 250 50 50 2 1
5 1050 650 50 50 2 1
5 1050 800 50 50 2 1
5 850 200 50 50 2 1
5 900 750 50 50 2 1
16 200 800 50 50 2 1
16 200 850 50 50 2 1
16 250 800 50 50 2 1
16 250 850 50 50 2 1
16 500 850 50 50 2 1
16 500 900 50 50 2 1
16 550 850 50 50 2 1
16 550 900 50 50 2 1
16 100 150 50 50 2 1
16 100 200 50 50 2 1
16 150 150 50 50 2 1
16 150 200 50 50 2 1
16 500 250 50 50 2 1
16 550 250 50 50 2 1
16 550 300 50 50 2 1
16 500 300 50 50 2 1
16 750 150 50 50 2 1
16 750 200 50 50 2 1
16 800 150 50 50 2 1
16 800 200 50 50 2 1
16 400 100 50 50 2 1
16 400 150 50 50 2 1
16 450 100 50 50 2 1
16 450 150 50 50 2 1
16 250 300 100 100 2 1
16 350 650 100 100 2 1
4 0 0 50 50 2 1
4 0 50 50 50 2 1
4 0 100 50 50 2 1
4 0 150 50 50 2 1
4 0 200 50 50 2 1
4 0 250 50 50 2 1
4 0 300 50 50 2 1
4 0 350 50 50 2 1
4 0 400 50 50 2 1
4 0 450 50 50 2 1
4 0 500 50 50 2 1
4 0 550 50 50 2 1
4 0 600 50 50 2 1
4 0 650 50 50 2 1
4 0 700 50 50 2 1
4 0 750 50 50 2 1
4 0 800 50 50 2 1
4 0 850 50 50 2 1
4 0 900 50 50 2 1
4 0 950 50 50 2 1
CEnemy:
1100 150 50 50 0 5 10 1
1100 250 50 50 0 5 10 1
1100 300 50 50 0 5 10 1
1100 750 50 50 0 5 10 1
1100 400 50 50 0 5 10 1
1100 450 50 50 0 5 10 1
898 644 100 100 25 2 6 4
1100 550 50 50 0 5 10 1
1100 600 50 50 0 5 10 1
