CObject:
2 1100 900 50 50 2 1
2 1150 900 50 50 2 1
2 1150 850 50 50 2 1
2 1150 800 50 50 2 1
2 1150 750 50 50 2 1
2 1150 700 50 50 2 1
2 1150 650 50 50 2 1
2 1150 600 50 50 2 1
2 1150 550 50 50 2 1
2 1150 500 50 50 2 1
2 1150 400 50 50 2 1
2 1150 350 50 50 2 1
2 1150 450 50 50 2 1
2 1150 250 50 50 2 1
2 1150 200 50 50 2 1
2 1150 300 50 50 2 1
2 1150 100 50 50 2 1
2 1150 50 50 50 2 1
2 1150 150 50 50 2 1
2 1150 0 50 50 2 1
2 1100 0 50 50 2 1
2 1050 0 50 50 2 1
2 1000 0 50 50 2 1
2 950 0 50 50 2 1
2 850 0 50 50 2 1
2 800 0 50 50 2 1
2 750 0 50 50 2 1
2 650 0 50 50 2 1
2 600 0 50 50 2 1
2 550 0 50 50 2 1
2 500 0 50 50 2 1
2 400 0 50 50 2 1
2 350 0 50 50 2 1
2 300 0 50 50 2 1
2 150 0 50 50 2 1
2 100 0 50 50 2 1
2 50 0 50 50 2 1
2 0 0 50 50 2 1
2 200 0 50 50 2 1
2 250 0 50 50 2 1
2 450 0 50 50 2 1
2 900 0 50 50 2 1
2 700 0 50 50 2 1
2 1200 0 50 50 2 1
2 1250 0 50 50 2 1
2 1200 50 50 50 2 1
2 1250 150 50 50 2 1
2 1200 150 50 50 2 1
2 1200 200 50 50 2 1
2 1250 300 50 50 2 1
2 1250 350 50 50 2 1
2 1250 400 50 50 2 1
2 1200 450 50 50 2 1
2 1200 500 50 50 2 1
2 1250 600 50 50 2 1
2 1200 650 50 50 2 1
2 1200 700 50 50 2 1
2 1250 800 50 50 2 1
2 1250 850 50 50 2 1
2 1200 900 50 50 2 1
2 1100 950 50 50 2 1
2 1050 950 50 50 2 1
2 1150 950 50 50 2 1
2 1200 800 50 50 2 1
2 1250 700 50 50 2 1
2 1250 650 50 50 2 1
15 1250 250 50 50 2 1
15 1200 250 50 50 2 1
15 1200 300 50 50 2 1
15 1200 350 50 50 2 1
15 1200 400 50 50 2 1
15 1250 450 50 50 2 1
15 1250 500 50 50 2 1
15 1250 550 50 50 2 1
15 1200 550 50 50 2 1
15 1200 600 50 50 2 1
15 1300 600 50 50 2 1
15 1300 650 50 50 2 1
15 1300 700 50 50 2 1
15 1300 750 50 50 2 1
15 1250 750 50 50 2 1
15 1200 750 50 50 2 1
15 1200 850 50 50 2 1
15 1250 900 50 50 2 1
15 1200 950 50 50 2 1
15 1250 950 50 50 2 1
15 1300 950 50 50 2 1
15 1300 900 50 50 2 1
15 1300 850 50 50 2 1
15 1300 800 50 50 2 1
15 1400 850 50 50 2 1
15 1350 900 50 50 2 1
15 1350 950 50 50 2 1
15 1350 850 50 50 2 1
15 1400 900 50 50 2 1
15 1450 950 50 50 2 1
15 1450 900 50 50 2 1
15 1450 850 50 50 2 1
15 1400 950 50 50 2 1
15 1450 800 50 50 2 1
15 1400 800 50 50 2 1
15 1350 800 50 50 2 1
15 1400 750 50 50 2 1
15 1400 700 50 50 2 1
15 1350 750 50 50 2 1
15 1450 650 50 50 2 1
15 1450 700 50 50 2 1
15 1350 700 50 50 2 1
15 1350 650 50 50 2 1
15 1400 650 50 50 2 1
15 1450 600 50 50 2 1
15 1400 600 50 50 2 1
15 1450 750 50 50 2 1
15 1350 550 50 50 2 1
15 1300 550 50 50 2 1
15 1350 600 50 50 2 1
15 1400 550 50 50 2 1
15 1450 500 50 50 2 1
15 1400 500 50 50 2 1
15 1450 550 50 50 2 1
15 1350 500 50 50 2 1
15 1300 500 50 50 2 1
15 1350 400 50 50 2 1
15 1450 400 50 50 2 1
15 1350 450 50 50 2 1
15 1300 450 50 50 2 1
15 1300 400 50 50 2 1
15 1400 400 50 50 2 1
15 1400 450 50 50 2 1
15 1450 350 50 50 2 1
15 1450 450 50 50 2 1
15 1400 350 50 50 2 1
15 1350 350 50 50 2 1
15 1300 350 50 50 2 1
15 1300 300 50 50 2 1
15 1350 250 50 50 2 1
15 1300 250 50 50 2 1
15 1350 300 50 50 2 1
15 1400 250 50 50 2 1
15 1400 300 50 50 2 1
15 1450 250 50 50 2 1
15 1450 200 50 50 2 1
15 1450 300 50 50 2 1
15 1400 200 50 50 2 1
15 1300 200 50 50 2 1
15 1250 200 50 50 2 1
15 1350 200 50 50 2 1
15 1350 150 50 50 2 1
15 1300 150 50 50 2 1
15 1300 100 50 50 2 1
15 1250 100 50 50 2 1
15 1250 50 50 50 2 1
15 1300 50 50 50 2 1
15 1350 50 50 50 2 1
15 1350 100 50 50 2 1
15 1400 150 50 50 2 1
15 1400 100 50 50 2 1
15 1400 0 50 50 2 1
15 1350 0 50 50 2 1
15 1300 0 50 50 2 1
15 1200 100 50 50 2 1
15 1450 100 50 50 2 1
15 1450 50 50 50 2 1
15 1400 50 50 50 2 1
15 1450 0 50 50 2 1
15 1450 150 50 50 2 1
5 50 100 50 50 2 1
5 250 100 50 50 2 1
5 550 100 50 50 2 1
5 850 100 50 50 2 1
2 150 450 50 50 2 1
2 150 500 50 50 2 1
2 200 450 50 50 2 1
2 200 500 50 50 2 1
2 150 550 50 50 2 1
2 200 550 50 50 2 1
2 250 500 50 50 2 1
2 250 450 50 50 2 1
2 250 550 50 50 2 1
2 500 500 50 50 2 1
2 500 550 50 50 2 1
2 550 500 50 50 2 1
2 550 550 50 50 2 1
2 850 400 150 150 2 1
2 650 700 100 100 2 1
1 100 450 50 50 2 1
1 100 500 50 50 2 1
1 100 550 50 50 2 1
1 100 600 50 50 2 1
1 200 600 50 50 2 1
1 250 600 50 50 2 1
1 150 600 50 50 2 1
1 300 600 50 50 2 1
1 300 550 50 50 2 1
1 300 500 50 50 2 1
1 300 450 50 50 2 1
1 300 400 50 50 2 1
1 250 400 50 50 2 1
1 200 400 50 50 2 1
1 150 400 50 50 2 1
1 100 400 50 50 2 1
1 450 450 50 50 2 1
1 450 500 50 50 2 1
1 450 550 50 50 2 1
1 450 600 50 50 2 1
1 500 600 50 50 2 1
1 550 600 50 50 2 1
1 600 600 50 50 2 1
1 600 550 50 50 2 1
1 600 500 50 50 2 1
1 600 450 50 50 2 1
1 550 450 50 50 2 1
1 500 450 50 50 2 1
1 600 650 50 50 2 1
1 600 700 50 50 2 1
1 600 750 50 50 2 1
1 600 800 50 50 2 1
1 650 800 50 50 2 1
1 700 800 50 50 2 1
1 750 800 50 50 2 1
1 750 750 50 50 2 1
1 750 650 50 50 2 1
1 700 650 50 50 2 1
1 650 650 50 50 2 1
1 750 700 50 50 2 1
1 800 350 50 50 2 1
1 800 400 50 50 2 1
1 800 450 50 50 2 1
1 800 550 50 50 2 1
1 850 550 50 50 2 1
1 900 550 50 50 2 1
1 950 550 50 50 2 1
1 1000 550 50 50 2 1
1 1000 500 50 50 2 1
1 1000 450 50 50 2 1
1 1000 400 50 50 2 1
1 1000 350 50 50 2 1
1 900 350 50 50 2 1
1 850 350 50 50 2 1
1 950 350 50 50 2 1
1 800 500 50 50 2 1
CEnemy:
680 184 80 80 20 10 10 3
248 219 50 50 15 3 5 2
988 116 50 50 10 5 10 1
678 565 60 60 20 4 10 3
32 315 50 50 10 5 10 2
