CObject:
2 1450 0 50 50 2 1
2 1350 0 50 50 2 1
2 1300 0 50 50 2 1
2 1250 0 50 50 2 1
2 1400 0 50 50 2 1
4 300 0 50 50 2 1
4 350 0 50 50 2 1
4 400 0 50 50 2 1
4 450 0 50 50 2 1
4 500 0 50 50 2 1
2 200 250 50 50 2 1
2 200 300 50 50 2 1
2 250 250 50 50 2 1
2 1200 0 50 50 2 1
2 1300 50 50 50 2 1
2 1250 50 50 50 2 1
2 1100 0 50 50 2 1
2 1150 0 50 50 2 1
2 1000 0 50 50 2 1
2 900 0 50 50 2 1
2 800 0 50 50 2 1
2 650 0 50 50 2 1
2 250 300 50 50 2 1
2 550 450 50 50 2 1
2 250 0 50 50 2 1
2 150 0 50 50 2 1
2 100 0 50 50 2 1
2 200 0 50 50 2 1
2 50 0 50 50 2 1
2 0 0 50 50 2 1
2 0 50 50 50 2 1
2 100 50 50 50 2 1
2 150 50 50 50 2 1
2 50 50 50 50 2 1
2 600 500 50 50 2 1
2 250 50 50 50 2 1
2 200 50 50 50 2 1
2 300 50 50 50 2 1
2 600 550 50 50 2 1
2 600 600 50 50 2 1
2 950 200 50 50 2 1
2 550 650 50 50 2 1
2 500 50 50 50 2 1
2 550 0 50 50 2 1
2 1000 250 50 50 2 1
2 550 50 50 50 2 1
2 600 50 50 50 2 1
2 600 0 50 50 2 1
2 650 50 50 50 2 1
2 700 0 50 50 2 1
2 750 50 50 50 2 1
2 750 0 50 50 2 1
2 700 50 50 50 2 1
2 850 50 50 50 2 1
2 850 0 50 50 2 1
2 900 50 50 50 2 1
2 1000 50 50 50 2 1
2 1050 0 50 50 2 1
2 1050 50 50 50 2 1
2 1150 50 50 50 2 1
2 1000 300 50 50 2 1
2 950 0 50 50 2 1
2 950 50 50 50 2 1
2 800 50 50 50 2 1
2 1000 350 50 50 2 1
2 950 400 50 50 2 1
2 850 650 50 50 2 1
2 900 700 50 50 2 1
2 900 750 50 50 2 1
2 900 800 50 50 2 1
2 850 850 50 50 2 1
2 200 700 50 50 2 1
2 250 750 50 50 2 1
2 250 800 50 50 2 1
2 250 850 50 50 2 1
2 200 900 50 50 2 1
16 850 600 50 50 2 1
16 900 650 50 50 2 1
16 950 700 50 50 2 1
16 950 750 50 50 2 1
16 950 800 50 50 2 1
16 900 850 50 50 2 1
16 950 150 50 50 2 1
16 850 900 50 50 2 1
16 1000 200 50 50 2 1
16 1050 250 50 50 2 1
16 1050 300 50 50 2 1
16 1050 350 50 50 2 1
16 1000 400 50 50 2 1
16 950 450 50 50 2 1
16 550 400 50 50 2 1
16 600 450 50 50 2 1
16 650 500 50 50 2 1
16 650 550 50 50 2 1
16 650 600 50 50 2 1
16 600 650 50 50 2 1
16 550 700 50 50 2 1
16 200 650 50 50 2 1
16 250 700 50 50 2 1
16 300 750 50 50 2 1
16 300 800 50 50 2 1
16 300 850 50 50 2 1
16 250 900 50 50 2 1
16 200 950 50 50 2 1
16 200 200 50 50 2 1
16 250 200 50 50 2 1
16 300 200 50 50 2 1
16 300 300 50 50 2 1
16 300 350 50 50 2 1
16 250 350 50 50 2 1
16 200 350 50 50 2 1
16 150 350 50 50 2 1
16 150 300 50 50 2 1
16 150 250 50 50 2 1
16 150 200 50 50 2 1
16 300 250 50 50 2 1
5 50 250 50 50 2 1
5 50 750 50 50 2 1
5 500 550 50 50 2 1
5 900 300 50 50 2 1
5 800 750 50 50 2 1
5 150 800 50 50 2 1
5 50 850 50 50 2 1
6 950 250 50 50 2 1
6 950 350 50 50 2 1
6 850 700 50 50 2 1
6 850 800 50 50 2 1
7 550 500 50 50 2 1
7 550 600 50 50 2 1
1 1100 50 50 50 2 1
7 200 750 50 50 2 1
1 1200 50 50 50 2 1
7 200 850 50 50 2 1
1 1350 50 50 50 2 1
1 1400 50 50 50 2 1
1 1450 50 50 50 2 1
1 1400 100 50 50 2 1
1 1350 100 50 50 2 1
1 1200 100 50 50 2 1
1 1100 100 50 50 2 1
1 1050 100 50 50 2 1
1 1150 100 50 50 2 1
1 1300 150 50 50 2 1
1 1000 100 50 50 2 1
1 900 100 50 50 2 1
1 800 100 50 50 2 1
1 750 150 50 50 2 1
1 850 150 50 50 2 1
1 1150 150 50 50 2 1
1 1250 150 50 50 2 1
1 950 100 50 50 2 1
1 850 100 50 50 2 1
1 750 100 50 50 2 1
1 1450 950 50 50 2 1
1 1400 950 50 50 2 1
1 1350 950 50 50 2 1
1 1300 950 50 50 2 1
1 1250 950 50 50 2 1
1 1250 900 50 50 2 1
1 1300 900 50 50 2 1
1 1150 950 50 50 2 1
1 1150 900 50 50 2 1
1 1100 950 50 50 2 1
1 1000 950 50 50 2 1
1 1200 950 50 50 2 1
1 150 950 50 50 2 1
1 100 950 50 50 2 1
1 50 950 50 50 2 1
1 0 950 50 50 2 1
1 250 950 50 50 2 1
1 300 950 50 50 2 1
1 350 950 50 50 2 1
1 400 950 50 50 2 1
1 400 900 50 50 2 1
1 450 950 50 50 2 1
1 500 950 50 50 2 1
1 500 900 50 50 2 1
1 600 950 50 50 2 1
1 650 950 50 50 2 1
1 700 950 50 50 2 1
1 800 950 50 50 2 1
1 900 950 50 50 2 1
1 950 950 50 50 2 1
1 1050 950 50 50 2 1
1 700 900 50 50 2 1
1 750 900 50 50 2 1
1 750 950 50 50 2 1
1 550 950 50 50 2 1
1 550 900 50 50 2 1
1 850 950 50 50 2 1
1 0 100 50 50 2 1
1 50 100 50 50 2 1
1 0 150 50 50 2 1
1 100 100 50 50 2 1
1 150 100 50 50 2 1
1 200 100 50 50 2 1
1 700 100 50 50 2 1
14 1450 100 50 50 2 1
1 600 100 50 50 2 1
1 650 150 50 50 2 1
1 700 150 50 50 2 1
1 600 150 50 50 2 1
1 600 200 50 50 2 1
1 650 200 50 50 2 1
1 550 200 50 50 2 1
1 600 250 50 50 2 1
1 550 150 50 50 2 1
1 650 250 50 50 2 1
14 1400 150 50 50 2 1
1 700 300 50 50 2 1
14 1350 150 50 50 2 1
14 1000 900 50 50 2 1
14 1050 900 50 50 2 1
14 1100 850 50 50 2 1
14 1150 850 50 50 2 1
14 1200 900 50 50 2 1
CEnemy:
350 50 50 50 0 5 10 2
400 50 50 50 0 5 10 2
450 50 50 50 0 5 10 2
350 100 50 50 0 5 10 2
400 100 50 50 0 5 10 2
450 100 50 50 0 5 10 2
100 150 50 50 0 5 10 2
100 900 50 50 0 5 10 2
154 493 150 150 35 6 15 4
