CObject:
1 0 0 50 50 -1 1
1 50 0 50 50 0 1
1 100 0 50 50 0 1
1 150 0 50 50 0 1
1 200 0 50 50 0 1
1 250 0 50 50 0 1
1 350 0 50 50 0 1
1 300 0 50 50 0 1
1 0 100 50 50 0 1
1 50 100 50 50 0 1
1 100 100 50 50 0 1
1 150 100 50 50 0 1
1 200 100 50 50 0 1
1 250 100 50 50 0 1
1 300 100 50 50 0 1
2 50 0 50 50 0 1
2 250 0 50 50 0 1
2 0 100 50 50 0 1
2 300 100 50 50 0 1
2 150 100 50 50 0 1
3 50 100 50 50 0 1
3 100 100 50 50 0 1
3 200 100 50 50 0 1
3 250 100 50 50 0 1
2 400 0 50 50 0 1
2 450 0 50 50 0 1
2 500 0 50 50 0 1
2 350 100 50 50 0 1
2 350 150 50 50 0 1
2 300 150 50 50 0 1
2 250 200 50 50 0 1
2 200 250 50 50 0 1
2 300 300 50 50 0 1
2 300 250 50 50 0 1
2 250 250 50 50 0 1
2 250 300 50 50 0 1
2 300 350 50 50 0 1
2 200 400 50 50 0 1
2 250 400 50 50 0 1
2 100 500 50 50 0 1
2 50 550 50 50 0 1
1 200 650 50 50 0 1
1 200 550 50 50 0 1
1 100 550 50 50 0 1
1 0 650 50 50 0 1
1 200 700 50 50 0 1
1 300 600 50 50 0 1
1 100 650 50 50 0 1
1 100 750 50 50 0 1
1 500 600 50 50 0 1
1 450 500 50 50 0 1
1 250 550 50 50 0 1
1 500 650 50 50 0 1
1 550 550 50 50 0 1
1 450 550 50 50 0 1
1 300 650 50 50 0 1
1 150 600 50 50 0 1
1 50 550 50 50 0 1
1 350 650 50 50 0 1
1 350 700 50 50 0 1
1 550 600 50 50 0 1
1 350 550 50 50 0 1
1 650 650 50 50 0 1
1 750 550 50 50 0 1
1 600 500 50 50 0 1
1 650 550 50 50 0 1
1 600 600 50 50 0 1
1 200 600 50 50 0 1
1 650 500 50 50 0 1
1 250 500 50 50 0 1
1 350 500 50 50 0 1
1 400 600 50 50 0 1
1 700 650 50 50 0 1
1 750 600 50 50 0 1
1 650 600 50 50 0 1
1 450 650 50 50 0 1
1 600 650 50 50 0 1
1 700 550 50 50 0 1
3 200 450 50 50 0 1
3 250 450 50 50 0 1
3 300 450 50 50 0 1
3 350 450 50 50 0 1
3 450 450 50 50 0 1
3 500 450 50 50 0 1
3 550 450 50 50 0 1
3 400 450 50 50 0 1
5 150 800 50 50 0 1
5 300 750 50 50 0 1
5 200 900 50 50 0 1
5 500 850 50 50 0 1
5 450 800 50 50 0 1
2 50 650 50 50 0 1
2 250 650 50 50 0 1
2 500 650 50 50 0 1
2 150 600 50 50 0 1
2 150 550 50 50 0 1
6 1150 150 50 50 0 1
6 1350 150 50 50 0 1
6 1150 350 50 50 0 1
6 1300 400 50 50 0 1
6 1200 600 50 50 0 1
6 1000 500 50 50 0 1
6 900 300 50 50 0 1
7 850 150 50 50 0 1
7 800 400 50 50 0 1
7 1100 250 50 50 0 1
7 1200 600 50 50 0 1
7 1000 650 50 50 0 1
1 1000 400 50 50 0 1
1 950 450 50 50 0 1
1 1100 450 50 50 0 1
1 1150 350 50 50 0 1
1 950 300 50 50 0 1
1 1000 200 50 50 0 1
1 900 150 50 50 0 1
1 850 200 50 50 0 1
1 850 350 50 50 0 1
1 650 350 50 50 0 1
1 800 250 50 50 0 1
1 950 400 50 50 0 1
1 900 550 50 50 0 1
1 1200 450 50 50 0 1
1 1250 250 50 50 0 1
1 1000 300 50 50 0 1
1 800 500 50 50 0 1
1 850 450 50 50 0 1
1 900 400 50 50 0 1
1 800 450 50 50 0 1
1 750 500 50 50 0 1
1 950 350 50 50 0 1
1 1050 300 50 50 0 1
1 1050 200 50 50 0 1
1 900 300 50 50 0 1
1 850 400 50 50 0 1
1 750 450 50 50 0 1
1 300 550 50 50 0 1
1 500 550 50 50 0 1
1 1050 350 50 50 0 1
1 1050 250 50 50 0 1
1 1100 150 50 50 0 1
1 1050 150 50 50 0 1
2 1050 250 50 50 0 1
2 750 400 50 50 0 1
2 650 550 50 50 0 1
3 950 150 50 50 0 1
3 950 200 50 50 0 1
3 900 200 50 50 0 1
3 900 250 50 50 0 1
3 850 250 50 50 0 1
3 850 300 50 50 0 1
5 1250 800 50 50 0 1
5 1400 750 50 50 0 1
5 1400 600 50 50 0 1
2 1450 450 50 50 0 1
2 1400 450 50 50 0 1
2 1350 450 50 50 0 1
2 1300 450 50 50 0 1
2 1300 500 50 50 0 1
2 1250 500 50 50 0 1
2 1200 500 50 50 0 1
2 1150 550 50 50 0 1
2 1100 550 50 50 0 1
1 622 46 100 100 20 1
1 650 150 50 50 0 1
1 650 250 50 50 0 1
1 650 200 50 50 0 1
1 750 50 50 50 0 1
1 750 100 50 50 0 1
1 700 150 50 50 0 1
CPlayer:
50 50 100 100
CEnemy:
350 800 50 50 0 5 10 1
250 800 50 50 0 5 10 1
150 900 50 50 0 5 10 1
500 900 50 50 0 5 10 1
600 750 50 50 0 5 10 1
500 750 50 50 0 5 10 1
400 900 50 50 0 5 10 1
300 900 50 50 0 5 10 1
500 800 50 50 0 5 10 1
1300 700 50 50 0 5 10 1
1350 600 50 50 0 5 10 1
1350 550 50 50 0 5 10 1
1350 700 50 50 0 5 10 1
1300 850 50 50 0 5 10 1
1150 850 50 50 0 5 10 1
1200 700 50 50 0 5 10 1
1350 650 50 50 0 5 10 1
1300 750 50 50 0 5 10 1
1200 750 50 50 0 5 10 1
1192 55 100 100 10 10 20 2
484 205 100 100 1 10 10 1
