CObject:
2 1300 0 50 50 2 1
2 1300 100 50 50 2 1
2 1300 150 50 50 2 1
2 1300 50 50 50 2 1
2 1300 250 50 50 2 1
2 1300 300 50 50 2 1
2 1300 350 50 50 2 1
2 1300 450 50 50 2 1
2 1300 500 50 50 2 1
2 1300 550 50 50 2 1
2 1300 600 50 50 2 1
2 1300 650 50 50 2 1
2 1300 700 50 50 2 1
2 1300 750 50 50 2 1
2 1300 800 50 50 2 1
2 1300 850 50 50 2 1
2 1300 900 50 50 2 1
2 1300 950 50 50 2 1
2 1300 400 50 50 2 1
2 1300 200 50 50 2 1
17 1450 50 50 50 2 1
4 1350 0 150 50 2 1
2 300 0 1000 1000 2 1
17 1400 50 50 50 2 1
2 0 0 1000 1000 2 1
17 1350 50 50 50 2 1
17 1350 100 50 50 2 1
17 1400 100 50 50 2 1
17 1450 100 50 50 2 1
17 1450 150 50 50 2 1
17 1400 150 50 50 2 1
17 1350 150 50 50 2 1
17 1400 200 50 50 2 1
17 1350 200 50 50 2 1
17 1400 250 50 50 2 1
17 1450 200 50 50 2 1
17 1450 250 50 50 2 1
17 1400 300 50 50 2 1
17 1350 250 50 50 2 1
17 1350 300 50 50 2 1
17 1450 300 50 50 2 1
17 1400 350 50 50 2 1
17 1350 350 50 50 2 1
17 1450 350 50 50 2 1
17 1450 400 50 50 2 1
17 1350 400 50 50 2 1
17 1400 400 50 50 2 1
17 1400 450 50 50 2 1
17 1450 500 50 50 2 1
17 1450 450 50 50 2 1
17 1350 450 50 50 2 1
17 1400 500 50 50 2 1
17 1350 500 50 50 2 1
17 1400 550 50 50 2 1
17 1350 550 50 50 2 1
17 1450 550 50 50 2 1
17 1400 600 50 50 2 1
17 1350 650 50 50 2 1
17 1400 650 50 50 2 1
17 1450 600 50 50 2 1
17 1450 650 50 50 2 1
17 1350 600 50 50 2 1
17 1350 700 50 50 2 1
17 1450 700 50 50 2 1
17 1400 700 50 50 2 1
17 1400 750 50 50 2 1
17 1350 750 50 50 2 1
17 1450 750 50 50 2 1
17 1450 800 50 50 2 1
17 1400 800 50 50 2 1
17 1350 800 50 50 2 1
17 1400 850 50 50 2 1
17 1350 850 50 50 2 1
17 1450 850 50 50 2 1
17 1400 900 50 50 2 1
17 1350 900 50 50 2 1
17 1400 950 50 50 2 1
17 1450 900 50 50 2 1
17 1450 950 50 50 2 1
17 1350 950 50 50 2 1
CEnemy:
