CObject:
5 400 800 50 50 2 3
5 400 150 50 50 2 3
6 1450 450 50 50 2 3
6 1450 500 50 50 2 3
7 150 400 50 50 2 3
CEnemy:
40 373 75 75 5 5 3 2
21 483 85 85 20 5 10 4
400 450 50 50 0 5 10 1
400 550 50 50 0 5 10 1
300 350 50 50 0 5 10 1
500 700 50 50 0 5 10 1
350 100 50 50 0 5 10 1
450 150 50 50 0 5 10 1
550 100 50 50 0 5 10 1
550 150 50 50 0 5 10 1
1450 400 50 50 0 5 10 1
1400 450 50 50 0 5 10 1
1400 500 50 50 0 5 10 1
1450 550 50 50 0 5 10 1
1300 400 50 50 0 5 10 1
1300 500 50 50 0 5 10 1
1250 450 50 50 0 5 10 1
1350 550 50 50 0 5 10 1
1200 550 50 50 0 5 10 1
1200 450 50 50 0 5 10 1
