CObject:
5 600 150 50 50 2 1
4 1450 400 50 200 2 1
5 200 450 50 50 2 1
5 600 800 50 50 2 1
5 1150 450 50 50 2 1
CEnemy:
1100 400 50 50 0 5 10 1
1100 450 50 50 0 5 10 1
1100 500 50 50 0 5 10 1
1150 500 50 50 0 5 10 1
1200 500 50 50 0 5 10 1
1200 450 50 50 0 5 10 1
1200 400 50 50 0 5 10 1
1150 400 50 50 0 5 10 1
150 400 50 50 0 5 10 1
150 450 50 50 0 5 10 1
150 500 50 50 0 5 10 1
200 500 50 50 0 5 10 1
250 500 50 50 0 5 10 1
250 450 50 50 0 5 10 1
600 100 50 50 0 5 10 1
250 400 50 50 0 5 10 1
200 400 50 50 0 5 10 1
550 800 50 50 0 5 10 1
600 850 50 50 0 5 10 1
650 850 50 50 0 5 10 1
650 800 50 50 0 5 10 1
650 750 50 50 0 5 10 1
600 750 50 50 0 5 10 1
550 750 50 50 0 5 10 1
550 850 50 50 0 5 10 1
550 150 50 50 0 5 10 1
550 200 50 50 0 5 10 1
650 150 50 50 0 5 10 1
650 100 50 50 0 5 10 1
550 100 50 50 0 5 10 1
600 200 50 50 0 5 10 1
650 200 50 50 0 5 10 1
312 620 150 150 35 3 3 4
925 131 30 30 15 6 15 2
