CObject:
3 0 500 50 50 2 1
3 50 500 50 50 2 1
3 100 500 50 50 2 1
3 150 500 50 50 2 1
3 200 500 50 50 2 1
3 250 500 50 50 2 1
3 350 500 50 50 2 1
3 400 500 50 50 2 1
3 300 500 50 50 2 1
3 450 500 50 50 2 1
3 500 500 50 50 2 1
3 550 500 50 50 2 1
3 650 500 50 50 2 1
3 600 500 50 50 2 1
3 700 500 50 50 2 1
3 700 450 50 50 2 1
3 700 400 50 50 2 1
3 700 350 50 50 2 1
3 700 300 50 50 2 1
3 700 250 50 50 2 1
3 700 200 50 50 2 1
3 700 150 50 50 2 1
3 700 100 50 50 2 1
3 700 50 50 50 2 1
3 750 50 50 50 2 1
3 800 50 50 50 2 1
3 850 50 50 50 2 1
3 900 50 50 50 2 1
3 950 50 50 50 2 1
3 1050 50 50 50 2 1
3 1100 50 50 50 2 1
3 1200 50 50 50 2 1
3 1350 50 50 50 2 1
3 1400 50 50 50 2 1
3 1450 50 50 50 2 1
3 1300 50 50 50 2 1
3 1150 50 50 50 2 1
3 1000 50 50 50 2 1
3 0 750 50 50 2 1
3 50 750 50 50 2 1
3 100 750 50 50 2 1
3 150 750 50 50 2 1
3 200 750 50 50 2 1
3 250 750 50 50 2 1
3 300 750 50 50 2 1
3 350 750 50 50 2 1
3 400 750 50 50 2 1
3 450 750 50 50 2 1
3 500 750 50 50 2 1
3 550 750 50 50 2 1
3 600 750 50 50 2 1
3 650 750 50 50 2 1
3 700 750 50 50 2 1
3 750 750 50 50 2 1
3 800 750 50 50 2 1
3 850 750 50 50 2 1
3 900 750 50 50 2 1
3 950 750 50 50 2 1
3 950 700 50 50 2 1
3 950 650 50 50 2 1
3 950 600 50 50 2 1
3 950 550 50 50 2 1
3 950 500 50 50 2 1
3 950 450 50 50 2 1
3 950 400 50 50 2 1
1 650 450 50 50 2 1
3 950 300 50 50 2 1
3 950 350 50 50 2 1
3 950 250 50 50 2 1
3 1000 250 50 50 2 1
3 1100 250 50 50 2 1
3 1150 250 50 50 2 1
3 1250 250 50 50 2 1
3 1300 250 50 50 2 1
3 1400 250 50 50 2 1
3 1450 250 50 50 2 1
3 1350 250 50 50 2 1
3 1200 250 50 50 2 1
3 1050 250 50 50 2 1
3 1250 50 50 50 2 1
1 600 400 50 50 2 1
1 550 450 50 50 2 1
1 500 450 50 50 2 1
1 450 400 50 50 2 1
1 400 400 50 50 2 1
1 300 450 50 50 2 1
1 200 400 50 50 2 1
1 150 400 50 50 2 1
1 50 450 50 50 2 1
1 0 450 50 50 2 1
1 200 450 50 50 2 1
1 300 400 50 50 2 1
1 250 400 50 50 2 1
1 50 400 50 50 2 1
1 0 800 50 50 2 1
1 50 850 50 50 2 1
1 100 850 50 50 2 1
1 150 850 50 50 2 1
1 300 850 50 50 2 1
1 150 800 50 50 2 1
1 100 800 50 50 2 1
1 350 850 50 50 2 1
1 250 850 50 50 2 1
1 400 800 50 50 2 1
1 500 850 50 50 2 1
1 400 850 50 50 2 1
1 500 800 50 50 2 1
1 600 800 50 50 2 1
1 650 850 50 50 2 1
1 800 800 50 50 2 1
1 850 850 50 50 2 1
1 950 850 50 50 2 1
1 850 800 50 50 2 1
1 700 850 50 50 2 1
1 650 800 50 50 2 1
1 900 850 50 50 2 1
1 1000 750 50 50 2 1
1 1050 700 50 50 2 1
1 1050 650 50 50 2 1
1 1000 550 50 50 2 1
1 1050 500 50 50 2 1
1 1050 450 50 50 2 1
1 1000 400 50 50 2 1
1 1050 300 50 50 2 1
1 1150 350 50 50 2 1
1 1050 350 50 50 2 1
1 1000 300 50 50 2 1
1 1150 300 50 50 2 1
1 400 650 50 50 2 1
1 200 600 50 50 2 1
1 750 600 50 50 2 1
1 750 350 50 50 2 1
1 850 500 50 50 2 1
1 850 200 50 50 2 1
1 1100 150 50 50 2 1
1 850 100 50 50 2 1
1 1300 150 50 50 2 1
1 1350 100 50 50 2 1
1 800 0 50 50 2 1
1 1050 0 50 50 2 1
1 1300 0 50 50 2 1
14 150 700 50 50 2 1
14 100 600 50 50 2 1
14 100 650 50 50 2 1
14 300 550 50 50 2 1
14 350 600 50 50 2 1
14 300 700 50 50 2 1
14 500 650 50 50 2 1
14 500 600 50 50 2 1
14 600 650 50 50 2 1
14 650 600 50 50 2 1
14 750 700 50 50 2 1
14 900 650 50 50 2 1
14 800 550 50 50 2 1
14 850 450 50 50 2 1
14 850 350 50 50 2 1
14 750 200 50 50 2 1
14 950 100 50 50 2 1
14 950 150 50 50 2 1
14 850 150 50 50 2 1
14 1200 100 50 50 2 1
14 1200 200 50 50 2 1
14 1050 100 50 50 2 1
6 750 500 50 50 2 1
7 1300 200 50 50 2 1
14 100 150 50 50 2 1
14 450 100 50 50 2 1
14 350 250 50 50 2 1
14 1350 800 50 50 2 1
14 1200 600 50 50 2 1
14 1350 500 50 50 2 1
14 1100 800 50 50 2 1
14 250 100 50 50 2 1
14 600 300 50 50 2 1
4 1450 100 50 150 2 1
