CObject:
2 150 0 50 50 2 1
2 150 50 50 50 2 1
2 150 100 50 50 2 1
2 150 150 50 50 2 1
2 150 200 50 50 2 1
2 150 250 50 50 2 1
2 150 300 50 50 2 1
2 150 400 50 50 2 1
2 150 450 50 50 2 1
2 150 500 50 50 2 1
2 150 550 50 50 2 1
2 150 600 50 50 2 1
2 150 650 50 50 2 1
2 150 700 50 50 2 1
2 150 750 50 50 2 1
2 150 800 50 50 2 1
2 150 850 50 50 2 1
2 150 900 50 50 2 1
2 150 950 50 50 2 1
2 150 350 50 50 2 1
2 450 0 50 50 2 1
2 450 100 50 50 2 1
2 450 150 50 50 2 1
2 450 50 50 50 2 1
2 450 200 50 50 2 1
2 450 250 50 50 2 1
2 450 300 50 50 2 1
2 450 350 50 50 2 1
2 450 400 50 50 2 1
2 450 450 50 50 2 1
2 450 500 50 50 2 1
2 450 550 50 50 2 1
2 450 600 50 50 2 1
2 450 650 50 50 2 1
2 450 700 50 50 2 1
2 450 750 50 50 2 1
2 450 800 50 50 2 1
2 450 850 50 50 2 1
2 450 900 50 50 2 1
2 450 950 50 50 2 1
17 200 900 50 50 2 1
17 250 900 50 50 2 1
17 300 900 50 50 2 1
17 350 900 50 50 2 1
17 400 850 50 50 2 1
17 400 900 50 50 2 1
17 350 850 50 50 2 1
17 300 850 50 50 2 1
17 250 850 50 50 2 1
17 200 850 50 50 2 1
17 200 800 50 50 2 1
17 250 800 50 50 2 1
17 300 800 50 50 2 1
17 350 800 50 50 2 1
17 400 800 50 50 2 1
17 400 700 50 50 2 1
17 300 700 50 50 2 1
17 250 700 50 50 2 1
17 200 700 50 50 2 1
17 350 700 50 50 2 1
17 300 650 50 50 2 1
17 250 650 50 50 2 1
17 200 650 50 50 2 1
17 350 650 50 50 2 1
17 400 650 50 50 2 1
17 400 600 50 50 2 1
17 300 600 50 50 2 1
17 250 600 50 50 2 1
17 200 600 50 50 2 1
17 350 600 50 50 2 1
17 200 50 250 250 2 1
17 200 250 250 250 2 1
17 750 100 250 250 2 1
17 1100 450 250 250 2 1
17 650 500 250 250 2 1
17 1250 200 250 250 2 1
17 1100 100 250 250 2 1
17 1000 600 250 250 2 1
17 700 650 250 250 2 1
17 550 100 100 250 2 1
17 950 350 100 250 2 1
17 550 450 100 250 2 1
17 750 450 100 250 2 1
17 650 800 100 250 2 1
17 1050 100 200 100 2 1
17 650 0 200 100 2 1
17 850 400 200 100 2 1
17 1200 750 200 100 2 1
17 1200 850 200 100 2 1
17 1050 0 50 50 2 1
17 1350 50 50 50 2 1
17 1400 100 50 50 2 1
17 700 350 50 50 2 1
17 650 200 50 50 2 1
17 700 150 50 50 2 1
17 500 400 50 50 2 1
17 50 50 50 50 2 1
17 100 150 50 50 2 1
17 0 200 50 50 2 1
17 50 400 50 50 2 1
17 100 500 50 50 2 1
17 0 600 50 50 2 1
17 50 700 50 50 2 1
17 100 800 50 50 2 1
17 0 850 50 50 2 1
17 50 900 50 50 2 1
17 50 250 100 100 2 1
4 200 0 250 50 2 1
