CObject:
2 550 0 50 50 2 1
2 550 50 50 50 2 1
2 550 100 50 50 2 1
2 550 150 50 50 2 1
2 500 200 50 50 2 1
2 550 200 50 50 2 1
2 550 250 50 50 2 1
2 550 300 50 50 2 1
2 500 300 50 50 2 1
2 450 300 50 50 2 1
2 400 300 50 50 2 1
2 400 350 50 50 2 1
2 400 400 50 50 2 1
2 400 450 50 50 2 1
2 400 500 50 50 2 1
2 400 550 50 50 2 1
2 400 600 50 50 2 1
2 400 650 50 50 2 1
2 450 700 50 50 2 1
2 500 700 50 50 2 1
2 550 700 50 50 2 1
2 600 700 50 50 2 1
2 650 700 50 50 2 1
2 700 700 50 50 2 1
2 400 700 50 50 2 1
2 700 750 50 50 2 1
2 700 800 50 50 2 1
2 700 850 50 50 2 1
2 700 900 50 50 2 1
2 650 950 50 50 2 1
2 700 950 50 50 2 1
2 950 700 50 50 2 1
2 950 750 50 50 2 1
2 950 800 50 50 2 1
2 950 850 50 50 2 1
2 950 900 50 50 2 1
2 950 950 50 50 2 1
2 1000 950 50 50 2 1
2 1000 800 50 50 2 1
2 1100 750 50 50 2 1
2 550 800 50 50 2 1
2 600 750 50 50 2 1
2 650 750 50 50 2 1
2 300 500 50 50 2 1
2 350 450 50 50 2 1
2 350 550 50 50 2 1
2 350 750 50 50 2 1
2 550 750 50 50 2 1
2 350 300 50 50 2 1
2 450 150 50 50 2 1
2 500 0 50 50 2 1
2 500 50 50 50 2 1
2 700 0 50 50 2 1
2 700 50 50 50 2 1
2 700 100 50 50 2 1
2 700 150 50 50 2 1
2 700 200 50 50 2 1
2 700 250 50 50 2 1
2 700 300 50 50 2 1
2 750 300 50 50 2 1
2 800 300 50 50 2 1
2 850 300 50 50 2 1
2 900 300 50 50 2 1
2 1000 300 50 50 2 1
2 950 300 50 50 2 1
2 1050 300 50 50 2 1
2 1050 350 50 50 2 1
2 1050 400 50 50 2 1
2 1050 450 50 50 2 1
2 1050 500 50 50 2 1
2 1050 550 50 50 2 1
2 1050 600 50 50 2 1
2 1050 650 50 50 2 1
2 1050 700 50 50 2 1
2 1000 700 50 50 2 1
2 1150 700 50 50 2 1
2 1100 700 50 50 2 1
2 1100 600 50 50 2 1
2 1100 450 50 50 2 1
2 1000 200 50 50 2 1
2 850 250 50 50 2 1
2 800 250 50 50 2 1
2 800 200 50 50 2 1
2 750 50 50 50 2 1
2 750 150 50 50 2 1
2 1000 250 50 50 2 1
2 950 250 50 50 2 1
3 950 350 50 50 2 1
3 950 400 50 50 2 1
3 950 450 50 50 2 1
3 950 500 50 50 2 1
3 950 550 50 50 2 1
3 950 600 50 50 2 1
3 950 650 50 50 2 1
17 600 50 50 50 2 1
17 650 0 50 50 2 1
17 600 0 50 50 2 1
17 650 50 50 50 2 1
17 600 100 50 50 2 1
17 650 150 50 50 2 1
17 650 100 50 50 2 1
17 600 150 50 50 2 1
17 650 200 50 50 2 1
17 600 200 50 50 2 1
17 650 250 50 50 2 1
17 600 250 50 50 2 1
17 600 300 50 50 2 1
17 650 300 50 50 2 1
17 600 350 50 50 2 1
17 550 350 50 50 2 1
17 500 400 50 50 2 1
17 650 400 50 50 2 1
17 600 400 50 50 2 1
17 500 450 50 50 2 1
17 550 400 50 50 2 1
17 650 450 50 50 2 1
17 600 450 50 50 2 1
17 650 350 50 50 2 1
17 700 350 50 50 2 1
17 700 400 50 50 2 1
17 700 450 50 50 2 1
17 750 400 50 50 2 1
17 550 450 50 50 2 1
17 500 350 50 50 2 1
6 450 350 50 50 2 1
17 450 450 50 50 2 1
17 450 400 50 50 2 1
17 500 500 50 50 2 1
17 450 550 50 50 2 1
17 450 600 50 50 2 1
7 450 650 50 50 2 1
17 500 650 50 50 2 1
17 500 600 50 50 2 1
17 500 550 50 50 2 1
17 450 500 50 50 2 1
17 550 500 50 50 2 1
17 550 550 50 50 2 1
17 550 600 50 50 2 1
17 550 650 50 50 2 1
17 600 650 50 50 2 1
17 600 600 50 50 2 1
17 600 550 50 50 2 1
17 600 500 50 50 2 1
17 650 550 50 50 2 1
17 650 600 50 50 2 1
17 700 550 50 50 2 1
17 700 650 50 50 2 1
17 650 650 50 50 2 1
17 700 600 50 50 2 1
17 750 650 50 50 2 1
17 750 550 50 50 2 1
17 750 500 50 50 2 1
17 700 500 50 50 2 1
17 750 600 50 50 2 1
17 650 500 50 50 2 1
17 750 450 50 50 2 1
17 750 350 50 50 2 1
17 750 700 50 50 2 1
17 800 700 50 50 2 1
17 850 700 50 50 2 1
17 900 700 50 50 2 1
17 750 750 50 50 2 1
17 800 750 50 50 2 1
17 850 750 50 50 2 1
17 900 750 50 50 2 1
17 850 800 50 50 2 1
17 750 800 50 50 2 1
17 900 800 50 50 2 1
17 800 850 50 50 2 1
17 750 850 50 50 2 1
17 800 800 50 50 2 1
17 850 850 50 50 2 1
17 900 850 50 50 2 1
3 900 350 50 50 2 1
3 850 450 50 50 2 1
3 850 550 50 50 2 1
3 900 600 50 50 2 1
3 850 400 50 50 2 1
3 900 650 50 50 2 1
3 800 450 50 50 2 1
3 850 350 50 50 2 1
3 850 650 50 50 2 1
17 800 350 50 50 2 1
17 800 400 50 50 2 1
17 900 400 50 50 2 1
17 900 450 50 50 2 1
17 900 500 50 50 2 1
17 900 550 50 50 2 1
17 850 500 50 50 2 1
17 800 500 50 50 2 1
17 800 550 50 50 2 1
17 800 600 50 50 2 1
17 800 650 50 50 2 1
17 350 500 50 50 2 1
17 350 400 50 50 2 1
17 350 300 50 50 2 1
17 350 200 50 50 2 1
17 400 250 50 50 2 1
17 300 350 50 50 2 1
17 250 550 50 50 2 1
17 300 600 50 50 2 1
17 300 700 50 50 2 1
17 300 650 50 50 2 1
17 350 600 50 50 2 1
17 400 700 50 50 2 1
17 450 750 50 50 2 1
17 500 750 50 50 2 1
17 500 800 50 50 2 1
17 450 800 50 50 2 1
17 350 700 50 50 2 1
17 600 850 50 50 2 1
17 1100 850 50 50 2 1
17 1000 850 50 50 2 1
17 1000 750 50 50 2 1
17 1100 600 50 50 2 1
17 1150 550 50 50 2 1
17 1100 450 50 50 2 1
17 1150 450 50 50 2 1
17 1150 350 50 50 2 1
17 1100 250 50 50 2 1
17 1000 250 50 50 2 1
17 900 250 50 50 2 1
17 800 250 50 50 2 1
17 750 250 50 50 2 1
17 800 100 50 50 2 1
17 750 50 50 50 2 1
17 750 0 50 50 2 1
17 750 100 50 50 2 1
17 850 200 50 50 2 1
17 450 50 50 50 2 1
17 500 50 50 50 2 1
17 500 0 50 50 2 1
17 400 100 50 50 2 1
17 450 150 50 50 2 1
17 450 200 50 50 2 1
2 500 100 50 50 2 1
2 450 50 50 50 2 1
2 400 800 50 50 2 1
2 550 850 50 50 2 1
2 650 900 50 50 2 1
1 400 0 50 50 2 1
1 300 100 50 50 2 1
1 300 200 50 50 2 1
1 200 300 50 50 2 1
1 250 400 50 50 2 1
1 200 450 50 50 2 1
1 200 550 50 50 2 1
1 150 650 50 50 2 1
1 200 750 50 50 2 1
1 250 800 50 50 2 1
1 300 850 50 50 2 1
1 450 900 50 50 2 1
1 1150 950 50 50 2 1
1 1050 900 50 50 2 1
1 1100 800 50 50 2 1
1 1200 800 50 50 2 1
1 1200 650 50 50 2 1
1 1200 550 50 50 2 1
1 1200 400 50 50 2 1
1 1150 400 50 50 2 1
1 1200 250 50 50 2 1
1 1100 200 50 50 2 1
1 1000 150 50 50 2 1
1 850 100 50 50 2 1
1 850 150 50 50 2 1
1 900 100 50 50 2 1
1 800 0 50 50 2 1
4 750 900 200 100 2 1
CEnemy:
1000 400 50 50 0 5 10 5
1000 600 50 50 0 5 10 5
