CObject:
2 0 300 50 50 1 1
2 50 300 50 50 1 1
2 100 300 50 50 1 1
2 250 300 50 50 1 1
2 300 300 50 50 1 1
2 350 300 50 50 1 1
2 400 300 50 50 1 1
2 400 250 50 50 1 1
2 400 200 50 50 1 1
2 400 150 50 50 1 1
2 400 100 50 50 1 1
2 400 50 50 50 1 1
2 400 0 50 50 1 1
2 0 650 50 50 1 1
2 50 650 50 50 1 1
2 100 650 50 50 1 1
2 350 650 50 50 1 1
2 300 650 50 50 1 1
2 250 650 50 50 1 1
2 400 650 50 50 1 1
2 400 700 50 50 1 1
2 400 750 50 50 1 1
2 400 800 50 50 1 1
2 400 850 50 50 1 1
2 400 900 50 50 1 1
2 400 950 50 50 1 1
1 300 400 50 50 1 1
1 300 450 50 50 1 1
1 300 500 50 50 1 1
1 300 550 50 50 1 1
1 100 400 50 50 1 1
1 100 450 50 50 1 1
1 100 500 50 50 1 1
1 150 400 50 50 1 1
1 150 450 50 50 1 1
1 150 500 50 50 1 1
1 150 550 50 50 1 1
1 100 550 50 50 1 1
1 200 550 50 50 1 1
1 200 500 50 50 1 1
1 200 450 50 50 1 1
1 200 400 50 50 1 1
1 250 400 50 50 1 1
1 250 450 50 50 1 1
1 250 500 50 50 1 1
1 250 550 50 50 1 1
1 200 300 50 50 1 1
1 150 300 50 50 1 1
1 150 350 50 50 1 1
1 200 350 50 50 1 1
1 150 600 50 50 1 1
1 150 650 50 50 1 1
1 200 600 50 50 1 1
1 200 650 50 50 1 1
1 250 600 50 50 1 1
1 300 600 50 50 1 1
1 350 600 50 50 1 1
1 350 550 50 50 1 1
1 350 450 50 50 1 1
1 350 400 50 50 1 1
1 350 500 50 50 1 1
1 350 350 50 50 1 1
1 300 350 50 50 1 1
1 250 350 50 50 1 1
1 400 350 50 50 1 1
1 400 400 50 50 1 1
1 400 450 50 50 1 1
1 400 500 50 50 1 1
1 400 550 50 50 1 1
1 400 600 50 50 1 1
16 150 700 50 50 1 1
16 200 700 50 50 1 1
7 50 50 50 50 1 1
7 150 50 50 50 1 1
6 150 800 50 50 1 1
6 200 800 50 50 1 1
7 250 50 50 50 1 1
7 50 150 50 50 1 1
7 150 150 50 50 1 1
7 250 150 50 50 1 1
15 450 350 50 50 1 1
15 450 400 50 50 1 1
15 500 350 50 50 1 1
15 500 400 50 50 1 1
15 450 450 50 50 1 1
15 500 450 50 50 1 1
15 450 500 50 50 1 1
15 500 550 50 50 1 1
15 450 550 50 50 1 1
15 500 500 50 50 1 1
15 450 600 50 50 1 1
15 500 600 50 50 1 1
15 450 300 50 50 1 1
15 500 300 50 50 1 1
15 550 300 50 50 1 1
15 550 350 50 50 1 1
15 550 450 50 50 1 1
15 550 500 50 50 1 1
15 550 550 50 50 1 1
15 550 600 50 50 1 1
15 550 650 50 50 1 1
15 450 650 50 50 1 1
15 500 650 50 50 1 1
15 550 400 50 50 1 1
15 550 250 50 50 1 1
15 500 250 50 50 1 1
15 450 250 50 50 1 1
15 450 200 50 50 1 1
15 500 200 50 50 1 1
15 550 150 50 50 1 1
15 500 150 50 50 1 1
15 450 150 50 50 1 1
15 550 200 50 50 1 1
15 550 100 50 50 1 1
15 500 100 50 50 1 1
15 450 100 50 50 1 1
15 450 50 50 50 1 1
15 500 50 50 50 1 1
15 550 50 50 50 1 1
15 550 0 50 50 1 1
15 500 0 50 50 1 1
15 450 0 50 50 1 1
15 450 700 50 50 1 1
15 500 700 50 50 1 1
15 550 700 50 50 1 1
15 550 750 50 50 1 1
15 500 750 50 50 1 1
15 450 750 50 50 1 1
15 450 800 50 50 1 1
15 500 800 50 50 1 1
15 550 800 50 50 1 1
15 550 850 50 50 1 1
15 500 850 50 50 1 1
15 450 850 50 50 1 1
15 450 900 50 50 1 1
15 500 900 50 50 1 1
15 550 900 50 50 1 1
15 550 950 50 50 1 1
15 500 950 50 50 1 1
15 450 950 50 50 1 1
2 1450 300 50 50 1 1
2 1400 300 50 50 1 1
2 1350 300 50 50 1 1
2 1350 350 50 50 1 1
2 1350 400 50 50 1 1
2 1350 450 50 50 1 1
2 1350 500 50 50 1 1
2 1400 500 50 50 1 1
2 1450 500 50 50 1 1
1 1250 350 50 50 1 1
1 1200 400 50 50 1 1
1 1200 350 50 50 1 1
1 1300 350 50 50 1 1
1 1250 400 50 50 1 1
1 1250 450 50 50 1 1
1 1300 400 50 50 1 1
1 1300 450 50 50 1 1
1 1250 500 50 50 1 1
1 1300 500 50 50 1 1
1 1200 450 50 50 1 1
1 1200 500 50 50 1 1
1 1200 550 50 50 1 1
1 1300 550 50 50 1 1
1 1350 600 50 50 1 1
1 1300 600 50 50 1 1
1 1250 550 50 50 1 1
1 1300 300 50 50 1 1
1 1250 300 50 50 1 1
1 1300 250 50 50 1 1
1 1250 600 50 50 1 1
1 1300 650 50 50 1 1
1 1350 650 50 50 1 1
1 1350 550 50 50 1 1
1 1200 300 50 50 1 1
1 1250 250 50 50 1 1
1 1350 200 50 50 1 1
1 1350 250 50 50 1 1
1 1400 200 50 50 1 1
1 1400 250 50 50 1 1
1 1450 200 50 50 1 1
1 1450 250 50 50 1 1
1 1450 150 50 50 1 1
1 1400 150 50 50 1 1
1 1350 150 50 50 1 1
1 1250 200 50 50 1 1
1 1100 400 50 50 1 1
1 1100 450 50 50 1 1
1 1100 550 50 50 1 1
1 1150 600 50 50 1 1
1 1200 650 50 50 1 1
1 1300 700 50 50 1 1
1 1400 700 50 50 1 1
1 1450 700 50 50 1 1
1 1350 700 50 50 1 1
1 1250 650 50 50 1 1
1 1200 600 50 50 1 1
1 1150 550 50 50 1 1
1 1150 500 50 50 1 1
1 1150 450 50 50 1 1
1 1150 400 50 50 1 1
1 1150 300 50 50 1 1
1 1200 250 50 50 1 1
1 1100 500 50 50 1 1
1 1150 350 50 50 1 1
1 1300 200 50 50 1 1
1 1250 700 50 50 1 1
1 1300 750 50 50 1 1
1 1350 750 50 50 1 1
1 1400 750 50 50 1 1
1 1400 650 50 50 1 1
1 1450 650 50 50 1 1
1 1450 600 50 50 1 1
1 1400 600 50 50 1 1
1 1400 550 50 50 1 1
1 1450 550 50 50 1 1
1 1450 750 50 50 1 1
1 1450 800 50 50 1 1
1 1400 800 50 50 1 1
1 1350 800 50 50 1 1
1 1450 100 50 50 1 1
1 1400 100 50 50 1 1
1 1450 50 50 50 1 1
1 1400 850 50 50 1 1
1 1450 850 50 50 1 1
1 1450 900 50 50 1 1
1 1050 400 50 50 1 1
1 1050 500 50 50 1 1
1 1050 550 50 50 1 1
1 1000 450 50 50 1 1
1 1050 450 50 50 1 1
1 1000 500 50 50 1 1
14 950 450 50 50 1 1
1 1100 350 50 50 1 1
1 1150 250 50 50 1 1
1 1300 150 50 50 1 1
1 1350 100 50 50 1 1
1 1400 50 50 50 1 1
17 700 250 50 50 1 1
17 700 300 50 50 1 1
17 700 350 50 50 1 1
17 700 400 50 50 1 1
17 700 500 50 50 1 1
17 700 550 50 50 1 1
17 700 450 50 50 1 1
17 750 450 50 50 1 1
17 750 500 50 50 1 1
17 750 550 50 50 1 1
17 800 500 50 50 1 1
17 800 550 50 50 1 1
17 800 450 50 50 1 1
17 800 400 50 50 1 1
17 750 400 50 50 1 1
17 750 350 50 50 1 1
17 800 350 50 50 1 1
17 800 300 50 50 1 1
17 750 300 50 50 1 1
17 750 250 50 50 1 1
17 800 250 50 50 1 1
17 900 250 50 50 1 1
17 900 300 50 50 1 1
17 900 350 50 50 1 1
17 900 400 50 50 1 1
17 900 450 50 50 1 1
17 900 500 50 50 1 1
17 900 550 50 50 1 1
17 650 250 50 50 1 1
17 650 300 50 50 1 1
17 650 350 50 50 1 1
17 650 450 50 50 1 1
17 650 500 50 50 1 1
17 650 550 50 50 1 1
17 650 400 50 50 1 1
17 650 650 50 50 1 1
17 700 650 50 50 1 1
17 750 650 50 50 1 1
17 850 650 50 50 1 1
17 900 650 50 50 1 1
17 800 650 50 50 1 1
17 650 150 50 50 1 1
17 700 150 50 50 1 1
17 750 150 50 50 1 1
17 850 150 50 50 1 1
17 900 150 50 50 1 1
17 800 150 50 50 1 1
14 850 200 50 50 1 1
14 800 200 50 50 1 1
14 750 200 50 50 1 1
14 700 200 50 50 1 1
14 650 200 50 50 1 1
14 900 200 50 50 1 1
14 850 250 50 50 1 1
14 850 300 50 50 1 1
14 850 350 50 50 1 1
14 850 400 50 50 1 1
14 850 450 50 50 1 1
14 850 500 50 50 1 1
14 850 550 50 50 1 1
14 850 600 50 50 1 1
14 900 600 50 50 1 1
14 800 600 50 50 1 1
14 750 600 50 50 1 1
14 700 600 50 50 1 1
14 650 600 50 50 1 1
14 650 700 50 50 1 1
14 700 700 50 50 1 1
14 750 700 50 50 1 1
14 800 700 50 50 1 1
14 850 700 50 50 1 1
14 900 700 50 50 1 1
14 950 700 50 50 1 1
14 950 650 50 50 1 1
14 950 600 50 50 1 1
14 950 550 50 50 1 1
14 950 500 50 50 1 1
14 950 400 50 50 1 1
14 950 350 50 50 1 1
14 950 300 50 50 1 1
14 950 250 50 50 1 1
14 950 200 50 50 1 1
14 950 150 50 50 1 1
14 950 100 50 50 1 1
14 900 100 50 50 1 1
14 850 100 50 50 1 1
14 750 100 50 50 1 1
14 700 100 50 50 1 1
14 650 100 50 50 1 1
14 800 100 50 50 1 1
14 1000 700 50 50 1 1
14 1000 650 50 50 1 1
14 850 800 50 50 1 1
14 1000 850 50 50 1 1
14 1150 800 50 50 1 1
14 1000 750 50 50 1 1
14 900 900 50 50 1 1
14 1150 900 50 50 1 1
14 1050 200 50 50 1 1
14 1100 150 50 50 1 1
14 1200 100 50 50 1 1
14 1000 0 50 50 1 1
14 850 0 50 50 1 1
14 1000 100 50 50 1 1
CPlayer:
50 450 1000 1000 100 100 9
CEnemy:
1450 400 50 50 0 5 10 1
